WWWWWWWWWWWWWWW
WPWFFWFFFFFFFFW
WFFFWWFWWWFWWFW
WFWFWFFWFWFWFWW
WFWFFFFWFWFFFWW
WWWFWWFFFWWWFFW
WFFFWFFWWWFFFWW
WWWFWWWWFFFWFFW
WFWFFFFFFWWWWFW
WFWFWWFWFWFFFFW
WFWFFWWWFWWWWFW
WFFFFFFFFWFFFFW
WWWFWWFWWWFWWWW
WFFFFWFWFFFFFGW
WWWWWWWWWWWWWEW